XXXXXXXXXXXXXXXXXXX
XR..D.R...T.......X
X..XXXXDXXXXXXXXX.X
X..XXXX.R.T.T.....X
XH.XXXXXXXXXXX...MX
XXXXXXXXXXXXXXXXXXX
