XXXXXXXXXXXXXXXXXXX
XR..D.T...D.O.D...X
X..XXXXDXXXXXXXXX.X
X..XXXX.R.T.T.....X
XH.XXXXXXXXXXX...MX
XXXXXXXXXXXXXXXXXXX
