%%%%%%%
%....o%
%..%..%
%G...P%
%%%%%%%
