%%%%%%%%%
%G.....o%
%.......%
%.......%
%.......%
%G.....P%
%%%%%%%%%
